+++++++++++++
+   0     Aa+
+ +++++++++ +
+           +
+++++++++++++
