++++++++++++
+       0+a+
+ ++++++++A+
+          +
+B++++++++C+
+b+c       +
++++++++++++
