yellow: 0,A
cyan: 1,B,C
++++++++++++++++++++++
+0                   +
++B ++++++++ +++++++ +
++A +      + +     +B+
++  +      + +     +1+
++  +      +b+     + +
++  +      + +     + +
++ c+      + +     + +
++  ++++++++ +++++++ +
+A       C          a+
++++++++++++++++++++++
