+++++++++++
+0   B  Aa+
+    +    +
+    +    +
+    +    +
+    +    +
+    +    +
+1       b+
+++++++++++
