blue: 0,A,E
cyan: 1,C,D
green: 2,B
++++++++++++++++
+CaAADAAAEBa   +
+ +++++++++    +
+              +
+              +
+  +++++++++  0+
+  a1  +ce++ +A+
++++++ +ad++ +2+
+ aa   +     +b+
++++++++++++++++
