blue:1,A
cyan:0,B
++++++++++
+a      b+
+A ++++ B+
+ ++++++ +
+1++++++0+
++++++++++
