cyan:1,B,D
+++++++++++++++++++
+0             Aa +
+                 +
+       Cc        +
+++++++++++++++++++
+            Dd   +
+                 +
+1              Bb+
+++++++++++++++++++
