cyan: 1,B,D,Y
+++++++++++++
+abcd   0   +
+++++     +++
+     1   AB+
+         CD+
+++++++++++++
