+++++++++
+0    Aa+
+++++++++
+1    Bb+
+++++++++
