++++++++
+     A+
+bbb   +
++++++0+
+BBBaaA+
++++++++
